##########
#..#...#.#
#..#...#.#
#....##..#
#.###....#
#...#....#
#.#...#..#
#.###.##.#
##.......#
##########